20
15
22 22 22 22 22 22 22 22 22 22 22 22 22 22 22 22 22 22 22 22 
22 19 17 17 17 17 17 17 17 17 17 17 17 17 17 17 17 17 18 22 
22 4 0 0 0 0 0 0 0 0 0 0 0 0 0 0 0 0 3 22 
22 4 0 0 0 0 0 0 0 0 0 0 0 0 0 0 0 0 3 22 
22 4 0 0 0 23 24 24 25 0 0 0 0 0 0 0 0 0 3 22 
22 4 0 0 0 0 0 0 0 0 0 0 0 0 0 0 0 0 3 22 
5 24 25 0 0 0 0 0 0 1 21 2 23 24 25 0 0 0 3 22 
22 4 0 0 0 0 0 0 0 3 22 4 0 0 0 0 23 25 3 22 
22 4 0 23 24 25 0 0 0 3 22 4 0 0 0 0 0 0 3 22 
22 4 0 0 0 0 26 26 26 3 22 4 0 0 0 0 0 0 3 22 
22 4 26 26 0 0 0 0 0 3 22 4 0 0 0 0 0 0 3 22 
22 4 0 0 0 0 23 24 25 3 22 1 21 2 23 25 0 0 3 22 
22 4 0 0 0 0 0 0 0 3 22 4 22 0 0 0 0 0 3 22 
5 21 21 21 21 21 2 0 0 3 5 21 6 4 1 21 21 21 21 6 
0 0 0 0 0 0 0 0 0 0 0 0 0 0 0 0 0 0 0 0 
